b0 b0 b0 b0 b0 b0 b1 b0 b0 b1 b0 b0 b0 b0 b0
b0 b0 b0 b0 b1 b0 b0 b0 b0 b0 b0 b0 b0 b0 b0
b0 b0 b0 b0 b0 b0 b0 b0 b0 b0 b0 b0 b0 b0 b0
b0 b0 b0 b0 b0 b0 b0 b0 b0 b0 b0 b0 b0 b0 b0
b0 b0 b0 b0 b0 b0 b0 b0 b0 b0 b0 b0 b0 b0 b0
b0 b0 b0 b0 b0 b0 b0 b0 b0 b0 b0 b0 b0 b0 b0
b0 b0 b0 b0 b0 b0 b0 b0 b0 b0 b0 b0 b0 b0 b0
b0 b0 b0 b0 b0 b0 b0 b0 b0 b0 b0 b0 b0 b0 b0
b0 b0 b0 b0 b0 b0 b0 b0 b0 b0 b0 b0 b0 b0 b0
b0 b0 b0 b0 b0 b0 b0 b0 b0 b0 b0 b0 b0 b0 b0
b0 b0 b0 b0 b0 b0 b0 b0 b0 b0 b0 b0 b0 b0 b0
b0 b0 b0 b0 b0 b0 b0 b0 b0 b0 b0 b0 b0 b0 b0
b0 b0 b0 b0 b0 b0 b0 b0 b0 b0 b0 b0 b0 b0 b0
b0 b0 b0 b0 b0 b0 b0 b0 b0 b0 b0 b0 b0 b0 b0
b0 b0 b0 b0 b0 b0 b0 b0 b0 b0 b0 b0 b0 b0 b0
