b0 b0 b0 b0 b0 b0 b0 b0 b0 b0 b0 b0 b0 b0 b0
b0 b0 b0 b0 b0 b0 b0 b0 b0 b0 b0 b0 b0 b0 b0
b0 b0 b0 b0 b0 b0 b0 b0 b0 b0 b0 b0 b0 b0 b0
b0 b0 b0 b0 b0 b0 b0 b0 b0 b0 b0 b0 b0 b0 b0
b0 b0 b0 b0 b0 b0 b0 b0 b0 b0 b0 b0 b0 b0 b0
b0 b0 b0 b0 b0 b0 b0 b0 b0 b0 b0 b0 b0 b0 b0
b0 b0 b0 b0 b0 b0 b0 b0 b0 b0 b0 b0 b0 b0 b0
b0 b0 b0 b0 b0 b0 b0 b0 b0 b0 b0 b0 b0 b0 b0
b0 b0 b0 b0 b0 b0 b0 b0 b0 h0 b0 b0 b0 b0 b0
b0 b0 b0 b0 b0 b0 b0 b0 h0 b0 b0 b0 b0 b0 b0
b0 b0 b0 b0 b0 b0 b0 b0 b0 b0 b0 b0 b0 b0 b0
b0 b0 b0 b0 b0 b0 b0 b0 b0 b0 b0 b0 b0 b0 b0
b0 b0 b0 b0 b0 b0 b0 b0 b0 b0 b0 b0 b0 b0 b0
b0 b0 b0 b0 b0 b0 b0 b0 b0 b0 b0 b0 b0 b0 b0
b0 b0 b0 b0 b0 b0 b0 b0 b0 b0 b0 b0 b0 b0 b0
